R 1980 1080

NO ./textures_hi/metal.xpm   
SO ./textures_hi/wood.xpm   
WE ./textures_hi/stone.xpm 
EA ./textures_hi/space.xpm

S ./textures_hi/mguard_s_2.xpm 
F 99,182,20
C 8,37,103

        1111111111111111111111111
        10000000001100222E2220001
        1011000001110000000000001
        1001000000000000002000001
111111111011000001110000000000001
100000000011000001111110111111111
111101111111110111000000100011111
111101111111110111010100100001111
110000001101010111000000100011111
100000000000000011000000000000001
100000000000000000010100100011111
110000011101010111110111100011111
11110111 1111101 101111010001
11111111 1111111 111111111111