R 1980 1080

NO ./textures_hi/1.xpm   
SO ./textures_hi/2.xpm   
WE ./textures_hi/3.xpm 
EA ./textures_hi/4.xpm

S ./textures_hi/2.xpm 
F 0,255,25
C 0,0,225

111111
100101
102001
1100N1
111111