R 1980 1080

NO ./textures_hi/stone.xpm   
SO ./textures_hi/brick.xpm   
WE ./textures_hi/wood.xpm 
EA ./textures_hi/brick.xpm

S ./textures_hi/2.xpm 
F 0,255,25
C 0,0,225

1111111111111111111111111
1000000000110000000000001
1011000001110000002000001
1001000000000000000000001
111111111011000001110000111111111
100000000011000001110111111111111
11110111111111000000000000001
11110111111111011101010000001
11000000110101011100000000001
100020000E0002001100000000001
10000000000000001101010010001
11000001110101011111011110001
11110111 1110101 101111010001
11111111 1111111 111111111111