R 1980 1080

NO ./textures_hi/1.xpm   
SO ./textures_hi/2.xpm   
WE ./textures_hi/3.xpm 
EA ./textures_hi/4.xpm

S ./textures_hi/2.xpm  
F 135,142,65
C 135,142,181

        1111111111111111111111111
        1000000000110000000000001
        1011000001110000000000001
        1001000000000000002000001
111111111011000001110000000000001
100000000011000001111110111111111
111101111111110100000000100011111
111101111111110111010100100001111    11111
110020001101010111000000100011111    12001
1000000N0000000011000000000000001    10001
100000000000000000000001000111111    10001
111111111110011111100000011111111    11111
11110111 1111101 101100010001
11000111 1100111 111111111111