R 1980 1080

NO ./textures_hi/metal.xpm   
SO ./textures_hi/slate.xpm   
WE ./textures_hi/stone_bricks.xpm 
EA ./textures_hi/stone.xpm

S ./textures_hi/4.xpm  
F 135,142,65
C 135,142,181

        1111111111111111111111111
        1000000000110000000000001
        1011000001110000000000001
        1001000000000000002000001
111111111011000001110000000000001
100000000011020001111110111111111
111101111111110100000000100011111
111101111111110111010100100001111
110000001101010111000000100011111
1000000N0000000011000000000000001
100200000000000000000001000111111
111111111110011111100000011111111
11110111 1111101 101100010001
11000111 1100111 111111111111